CC	/srv/scratch/annashch/stemcells/het/output/aggregate_heterokaryon_idr/nomouse/CC.idr.bed.nomouse
3hr	/srv/scratch/annashch/stemcells/het/output/aggregate_heterokaryon_idr/nomouse/3hr.idr.bed.nomouse
16hr	/srv/scratch/annashch/stemcells/het/output/aggregate_heterokaryon_idr/nomouse/16hr.idr.bed.nomouse
48hr	/srv/scratch/annashch/stemcells/het/output/aggregate_heterokaryon_idr/nomouse/48hr.idr.bed.nomouse
H1	/srv/scratch/annashch/stemcells/het/output/aggregate_heterokaryon_idr/nomouse/H1.idr.bed.nomouse
Hk	/srv/scratch/annashch/stemcells/het/output/aggregate_heterokaryon_idr/nomouse/Hk.idr.bed.nomouse
M5	/srv/scratch/annashch/stemcells/het/output/aggregate_heterokaryon_idr/nomouse/M5.idr.bed.nomouse
16hr.3hrDown	/srv/scratch/annashch/stemcells/het/output/aggregate_deseq2/filtered/16hr.3hrDown.filtered
16hr.3hrUp	/srv/scratch/annashch/stemcells/het/output/aggregate_deseq2/filtered/16hr.3hrUp.filtered
16hr.CCDown	/srv/scratch/annashch/stemcells/het/output/aggregate_deseq2/filtered/16hr.CCDown.filtered
16hr.CCUp	/srv/scratch/annashch/stemcells/het/output/aggregate_deseq2/filtered/16hr.CCUp.filtered
16hr.HkDown	/srv/scratch/annashch/stemcells/het/output/aggregate_deseq2/filtered/16hr.HkDown.filtered
16hr.HkUp	/srv/scratch/annashch/stemcells/het/output/aggregate_deseq2/filtered/16hr.HkUp.filtered
16hr.M5Down	/srv/scratch/annashch/stemcells/het/output/aggregate_deseq2/filtered/16hr.M5Down.filtered
16hr.M5Up	/srv/scratch/annashch/stemcells/het/output/aggregate_deseq2/filtered/16hr.M5Up.filtered
3hr.CCDown	/srv/scratch/annashch/stemcells/het/output/aggregate_deseq2/filtered/3hr.CCDown.filtered
3hr.CCUp	/srv/scratch/annashch/stemcells/het/output/aggregate_deseq2/filtered/3hr.CCUp.filtered
3hr.HkDown	/srv/scratch/annashch/stemcells/het/output/aggregate_deseq2/filtered/3hr.HkDown.filtered
3hr.HkUp	/srv/scratch/annashch/stemcells/het/output/aggregate_deseq2/filtered/3hr.HkUp.filtered
3hr.M5Down	/srv/scratch/annashch/stemcells/het/output/aggregate_deseq2/filtered/3hr.M5Down.filtered
3hr.M5Up	/srv/scratch/annashch/stemcells/het/output/aggregate_deseq2/filtered/3hr.M5Up.filtered
48hr.16hrDown	/srv/scratch/annashch/stemcells/het/output/aggregate_deseq2/filtered/48hr.16hrDown.filtered
48hr.16hrUp	/srv/scratch/annashch/stemcells/het/output/aggregate_deseq2/filtered/48hr.16hrUp.filtered
48hr.3hDown	/srv/scratch/annashch/stemcells/het/output/aggregate_deseq2/filtered/48hr.3hrDown.filtered
48hr.3hrUp	/srv/scratch/annashch/stemcells/het/output/aggregate_deseq2/filtered/48hr.3hrUp.filtered
48hr.CCDown	/srv/scratch/annashch/stemcells/het/output/aggregate_deseq2/filtered/48hr.CCDown.filtered
48hr.CCUp	/srv/scratch/annashch/stemcells/het/output/aggregate_deseq2/filtered/48hr.CCUp.filtered
48hr.HkDown	/srv/scratch/annashch/stemcells/het/output/aggregate_deseq2/filtered/48hr.HkDown.filtered
48hr.HkUp	/srv/scratch/annashch/stemcells/het/output/aggregate_deseq2/filtered/48hr.HkUp.filtered
48hr.M5Down	/srv/scratch/annashch/stemcells/het/output/aggregate_deseq2/filtered/48hr.M5Down.filtered
48hr.M5Up	/srv/scratch/annashch/stemcells/het/output/aggregate_deseq2/filtered/48hr.M5Up.filtered
H1.16hrDown	/srv/scratch/annashch/stemcells/het/output/aggregate_deseq2/filtered/H1.16hrDown.filtered
H1.16hrUp	/srv/scratch/annashch/stemcells/het/output/aggregate_deseq2/filtered/H1.16hrUp.filtered
H1.3hrDown	/srv/scratch/annashch/stemcells/het/output/aggregate_deseq2/filtered/H1.3hrDown.filtered
H1.3hrUp	/srv/scratch/annashch/stemcells/het/output/aggregate_deseq2/filtered/H1.3hrUp.filtered
H1.48hrDown	/srv/scratch/annashch/stemcells/het/output/aggregate_deseq2/filtered/H1.48hrDown.filtered
H1.48hrUp	/srv/scratch/annashch/stemcells/het/output/aggregate_deseq2/filtered/H1.48hrUp.filtered
H1.CCDown	/srv/scratch/annashch/stemcells/het/output/aggregate_deseq2/filtered/H1.CCDown.filtered
H1.CCUp	/srv/scratch/annashch/stemcells/het/output/aggregate_deseq2/filtered/H1.CCUp.filtered
H1.HkDown	/srv/scratch/annashch/stemcells/het/output/aggregate_deseq2/filtered/H1.HkDown.filtered
H1.HkUp	/srv/scratch/annashch/stemcells/het/output/aggregate_deseq2/filtered/H1.HkUp.filtered
H1.M5Down	/srv/scratch/annashch/stemcells/het/output/aggregate_deseq2/filtered/H1.M5Down.filtered
H1.M5Up	/srv/scratch/annashch/stemcells/het/output/aggregate_deseq2/filtered/H1.M5Up.filtered
